{  
   "lang":"Kazakh",
   "short":"kk",
   "kk":{  
      "А":"a", "а":"a",
      "Б":"b", "б":"b",
      "В":"v", "в":"v",
      "Г":"g", "г":"g",
      "Д":"d", "д":"d",
      "Е":"e", "е":"e",
      "Ж":"j", "ж":"j",
      "З":"z", "з":"z",
      "И":"ï", "и":"ï",
      "Й":"y", "й":"y",
      "К":"k", "к":"k",
      "Л":"l", "л":"l",
      "М":"m", "м":"m",
      "Н":"n", "н":"n",
      "О":"o", "о":"o",
      "П":"p", "п":"p",
      "Р":"r", "р":"r",
      "С":"s", "с":"s",
      "Т":"t", "т":"t",
      "У":"w", "у":"w",
      "Ф":"f", "ф":"f",
      "Х":"x", "х":"x",
      "Ц":"c", "ц":"c",
      "Ч":"ç", "ч":"ç",
      "Ш":"ş", "ш":"ş",
      "Щ":"şş", "щ":"şş",
      "Ъ":"(ʺ)", "ъ":"(ʺ)",
      "Ы":"ı", "ы":"ı",
      "Ь":"(ʹ)", "ь":"(ʹ)",
      "Э":"é", "э":"é",
      "Ю":"yw", "ю":"yw",
      "Я":"ya", "я":"ya",
      "Ё":"yo", "ё":"yo",
      "І":"i", "і":"i",
      "Ғ":"ğ", "ғ":"ğ",
      "Қ":"q", "қ":"q",
      "Ң":"ñ", "ң":"ñ",
      "Ү":"ü", "ү":"ü",
      "Ұ":"u", "ұ":"u",
      "Һ":"h", "һ":"h",
      "Ә":"ä", "ә":"ä",
      "Ө":"ö", "ө":"ö"
   }
}